00000000000000000000000000000000000005555555555555555555
00000000000000000000000000000000000001111111111111111111
00000000000000000000000000000000000000000000000000000000
00000000000000000000000000008111111100000000000000000000
00000000000000000000000000008155555577000000000000000000
00000000000000000000000000008155555577000000000000000000
00000000000000000000000000008155555577000000000000000000
30220400402000025020505042408055555577000050002420500222
11111111111110111111111111111111111111111111011111110111
11111111111117111111111111111111111111111111511111115111
11111111111117111111111111111111111111111111111111111111
00000000000000000000000000000000000000000000000000000000
00000000000000000000000000000000000000000000000000000000